88JC	서울특별시
가락IC	부산광역시
가산IC	경상북도
가조IC	경상남도
가좌IC	인천광역시
감곡IC	충청북도
강릉IC	강원도
강릉JC	강원도
강일IC	경기도
강진IC	전라남도
강촌IC	강원도
거창IC	경상남도
건천IC	경상북도
경기광주IC	경기도
경산IC	경상북도
경주IC	경상북도
계룡IC	충청남도
계양IC	인천광역시
고기JC남측	인천광역시
고기JC북측	인천광역시
고기터널남측	경기도
고기터널북측	경기도
고덕IC	충청남도
고등IC	경기도
고령IC	경상북도
고령JC	경상북도
고서JC	전라남도
고성IC	경상남도
고양IC	경기도
고잔TG	인천광역시
고창IC	전라북도
고창JC	전라북도
고흥IC	전라남도
곡성IC	전라남도
곤양IC	경상남도
곤지암IC	경기도
공주IC	충청남도
공주JC	충청남도
공항신도시JC	인천광역시
공항입구IC	인천광역시
광교IC	경기도
광명IC	경기도
광명역IC	경기도
광산IC	광주광역시
광양IC	전라남도
광주TG	전라남도
광천IC	충청남도
괴산IC	충청북도
구례화엄사	전라남도
구례화엄사IC	전라남도
구리IC	경기도
구리TG	경기도
구미IC	경상북도
구서IC	부산광역시
구포IC	부산광역시
군북IC	경상남도
군산IC	전라북도
군위IC	경상북도
군자JC	경기도
군자TG	경기도
군포IC	경기도
금강IC	충청북도
금광지하차도남측	경기도
금광지하차도북측	경기도
금산IC	충청남도
금산사IC	전라북도
금왕꽃동네IC	충청북도
금천IC	서울특별시
금토TG	경기도
금호JC	대구광역시
기장IC	부산광역시
기흥IC	경기도
기흥동탄IC	경기도
김제IC	전라북도
김천IC	경상북도
김천JC	경상북도
김포IC	경기도
김포TG	경기도
김포공항IC	경기도
김해JC	경상남도
나주IC	전라남도
낙동JC	경상북도
남강릉IC	강원도
남고창IC	전라북도
남공주IC	충청남도
남구미IC	경상북도
남김천IC	경상북도
남대구IC	대구광역시
남대전IC	대전광역시
남동IC	인천광역시
남밀양IC	경상남도
남상주IC	경상북도
남성주IC	경상북도
남세종IC	세종특별자치시
남순천TG	전라남도
남안동IC	경상북도
남안산IC	경기도
남안성IC	경기도
남양산IC	경상남도
남양주IC	경기도
남양주TG	경기도
남여주IC	경기도
남원IC	전라북도
남원JC	전라북도
남원주IC	강원도
남이JC	충청북도
남인천TG	인천광역시
남장수IC	전라북도
남제천IC	충청북도
남지IC	경상남도
남천안IC	충청남도
남청주IC	충청북도
남춘천IC	강원도
내서JC	경상남도
내장산IC	전라북도
냉정JC	경상남도
노오지JC	인천광역시
노온JC	충청북도
노포IC	부산광역시
논산IC	충청남도
논산JC	충청남도
다부IC	경상북도
단성IC	경상남도
단양IC	충청북도
달성IC	대구광역시
담양IC	전라남도
담양JC	전라남도
당진IC	충청남도
당진JC	충청남도
대덕JC	전라남도
대동IC	경상남도
대동JC	경상남도
대소IC	충청북도
대소JC	충청북도
대왕판교IC	경기도
대저JC	부산광역시
대전IC	대전광역시
대천IC	충청남도
덕소삼패IC	경기도
덕유산IC	전라북도
덕천IC	부산광역시
덕평IC	경기도
도동JC	대구광역시
도롱IC	전라남도
도리JC	경기도
도화IC	인천광역시
동고령IC	경상북도
동고성IC	경상남도
동광산TG	광주광역시
동광양IC	전라남도
동광주IC	광주광역시
동광주TG	광주광역시
동군산IC	전라북도
동군포IC	경기도
동김천IC	경상북도
동김해IC	경상남도
동대구IC	대구광역시
동대구JC	대구광역시
동림IC	광주광역시
동마산IC	경상남도
동산TG	강원도
동서울TG	경기도
동서천IC	충청남도
동서천JC	충청남도
동수원IC	경기도
동순천IC	전라남도
동전주IC	전라북도
동창원IC	경상남도
동충주IC	충청북도
동탄JC	경기도
동함평IC	전라남도
동해IC	강원도
동홍천IC	강원도
둔내IC	강원도
둔대JC	경기도
마곡사IC	충청남도
마산TG	경상남도
마성IC	경기도
마장JC	경기도
만종JC	강원도
망상IC	강원도
매송IC	경기도
면온IC	강원도
면천IC	충청남도
목감IC	경기도
목동교IC	서울특별시
목천IC	충청남도
목포IC	전라북도
목포TG	전라남도
무안IC	전라남도
무안공항IC	전라남도
무주IC	전라북도
무창포IC	충청남도
문경새재IC	경상북도
문막IC	강원도
문산IC	경상남도
문수IC	울산광역시
문의IC	충청북도
문평IC	전라남도
문학IC	인천광역시
문흥JC	광주광역시
물금IC	경상남도
물왕TG	경기도
미사IC	경기도
밀양IC	경상남도
반포IC	서울특별시
발안IC	경기도
백양사IC	전라남도
벌교IC	전라남도
별내IC	경기도
보성IC	전라남도
보은IC	충청북도
봉담IC	경기도
봉담TG	경기도
부곡IC	경기도
부산TG	부산광역시
부안IC	전라북도
부여IC	충청남도
부천IC	경기도
부평IC	인천광역시
북강릉IC	강원도
북공주JC	충청남도
북광주IC	전라남도
북남원IC	전라북도
북단양IC	충청북도
북대구IC	대구광역시
북대전IC	대전광역시
북로JC	경기도
북무안IC	전라남도
북부산TG	부산광역시
북상주IC	경상북도
북수원IC	경기도
북여주IC	경기도
북영천IC	경상북도
북오산IC	경기도
북원주IC	강원도
북인천IC	인천광역시
북진천IC	충청북도
북창원IC	경상남도
북천안IC	충청남도
북충주IC	충청북도
북통영IC	경상남도
북평택TG	경기도
비룡JC	대전광역시
비봉IC	경기도
사상IC	부산광역시
사천IC	경상남도
산곡JC	경기도
산내JC	대전광역시
산본IC	경기도
산월IC	광주광역시
산인JC	경상남도
산청IC	경상남도
삼락IC	부산광역시
삼랑진IC	경상남도
삼례IC	전라북도
상관IC	전라북도
상동IC	경상남도
상일IC	서울특별시
상주IC	경상북도
새말IC	강원도
생초IC	경상남도
서공주IC	충청남도
서공주JC	충청남도
서광산IC	광주광역시
서광주IC	광주광역시
서김제IC	전라북도
서김해IC	경상남도
서남원IC	전라북도
서논산IC	충청남도
서대구IC	대구광역시
서대구TG	대구광역시
서대전IC	대전광역시
서대전JC	대전광역시
서마산IC	경상남도
서부산IC	부산광역시
서부산TG	부산광역시
서부여IC	충청남도
서분당IC	경기도
서산IC	충청남도
서상IC	경상남도
서서울TG	경기도
서세종IC	세종특별자치시
서수지IC	경기도
서수지TG	경기도
서순천IC	전라남도
서안동IC	경상북도
서안산IC	경기도
서안성IC	경기도
서여주IC	경기도
서영암IC	전라남도
서영암TG	전라남도
서오산JC	경기도
서오산TG	경기도
서운JC	인천광역시
서울TG	경기도
서울산IC	울산광역시
서이천IC	경기도
서인천IC	인천광역시
서전주IC	전라북도
서종IC	경기도
서진주IC	경상남도
서창JC	인천광역시
서천IC	충청남도
서청주IC	충청북도
서초IC	서울특별시
서충주IC	충청북도
서판교IC남측	경기도
서판교IC북측	경기도
서평택IC	경기도
서평택JC	경기도
서포항IC	경상북도
서하남IC	경기도
서해안선시점	전라남도
서해안선종점	서울특별시
석곡IC	전라남도
석수IC	경기도
선동IC	경기도
선산IC	경상북도
선운산IC	전라북도
설악IC	경기도
성남IC	경기도
성남TG	경기도
성서IC	대구광역시
성주IC	경상북도
세곡터널남측	서울특별시
세곡터널북측	서울특별시
소양IC	전라북도
속리산IC	충청북도
속사IC	강원도
송내IC	인천광역시
송도IC	인천광역시
송산마도IC	경기도
송악IC	충청남도
송추IC	경기도
송탄IC	경기도
송파IC	서울특별시
수성IC	대구광역시
수원신갈IC	경기도
순창IC	전라북도
순천IC	전라남도
순천JC	전라남도
순천만IC	전라남도
순천완주선시점	전라남도
순천완주선종점	전라남도
승주IC	전라남도
시점(영암군학산면은곡리)	전라남도
시흥IC	경기도
시흥TG	경기도
신갈JC	경기도
신공항IC	경기도
신공항TG	인천광역시
신림IC	강원도
신불IC	인천광역시
신양IC	충청남도
신월IC	서울특별시
신월천교	경기도
신천IC	경기도
신탄진IC	대전광역시
심곡터널남측	경기도
심곡터널북측	경기도
안녕IC	경기도
안산IC	경기도
안산JC	경기도
안성IC	경기도
안성JC	경기도
안영IC	대전광역시
안현JC	경기도
양산IC	경상남도
양산JC	경상남도
양양IC	강원도
양재IC	서울특별시
양주TG	경기도
양지IC	경기도
양평IC	경기도
어연IC	경기도
언양JC	울산광역시
여주IC	경기도
여주JC	경기도
연무IC	충청남도
연성IC	경기도
연수JC	인천광역시
연풍IC	충청북도
연화산IC	경상남도
영광IC	전라남도
영동IC	충청북도
영락IC	부산광역시
영산IC	경상남도
영종IC	인천광역시
영주IC	경상북도
영천IC	경상북도
예산수덕IC	충청남도
예천IC	경상북도
오산IC	경기도
오성IC	경기도
오수IC	전라북도
오창IC	충청북도
옥계IC	강원도
옥곡IC	전라남도
옥과IC	전라남도
옥련IC	인천광역시
옥천IC	충청북도
옥포JC	대구광역시
온양IC	울산광역시
완주IC	전라북도
완주JC	전라북도
왜관IC	경상북도
용봉IC	광주광역시
용인IC	경기도
운수IC	광주광역시
운중터널남측	경기도
운중터널북측	경기도
울산IC	울산광역시
울산JCT	울산광역시
울산TG	울산광역시
원주IC	강원도
월곶JC	경기도
유구IC	충청남도
유성IC	대전광역시
유성JC	대전광역시
음성IC	충청북도
의성IC	경상북도
의정부IC	경기도
이천IC	경기도
익산IC	전라북도
익산JC	전라북도
인천TG	인천광역시
인천대교TG	인천광역시
인천시점	인천광역시
일광IC	부산광역시
일로IC	전라남도
일산IC	경기도
일죽IC	경기도
일직JC	경기도
임실IC	전라북도
자유로IC	경기도
잠원IC	서울특별시
장성IC	전라남도
장성JC	전라남도
장성물류IC	전라남도
장수IC	전라북도
장수JC	전라북도
장안IC	부산광역시
장유IC	경상남도
장지IC	경상남도
장평IC	강원도
장흥IC	전라남도
전주IC	전라북도
점촌함창IC	경상북도
정남IC	경기도
정안IC	충청남도
정왕IC	경기도
정읍IC	전라북도
제천IC	충청북도
제천JC	충청북도
조남JC	경기도
조암IC	경기도
조양IC	강원도
종점(순천시해룡면성산리)	전라남도
주암IC	전라남도
줄포IC	전라북도
중동IC	경기도
중앙고속국도종점	경상남도
증평IC	충청북도
지곡IC	경상남도
지리산IC	전라북도
지수IC	경상남도
진교IC	경상남도
진례IC	경상남도
진부IC	강원도
진성IC	경상남도
진안IC	전라북도
진월IC	전라남도
진주IC	경상남도
진주JC	경상남도
진천IC	충청북도
창녕IC	경상남도
창원JC	경상남도
창평IC	전라남도
천안IC	충청남도
천안JC	충청남도
천진암교	경기도
청계TG	경기도
청도IC	경상북도
청량IC	울산광역시
청북IC	경기도
청양IC	충청남도
청주IC	충청북도
청주JC	충청북도
청통와촌IC	경상북도
초정IC	경상남도
추부IC	충청남도
추풍령IC	경상북도
축동IC	경상남도
춘장대IC	충청남도
춘천IC	강원도
춘천JC	강원도
춘천TG	강원도
충주IC	충청북도
충주JC	충청북도
칠곡IC	경상북도
칠곡물류IC	경상북도
칠서IC	경상남도
칠원JC	경상남도
칠원TG	경상남도
탄천IC	충청남도
태인IC	전라북도
토평IC	경기도
통도사IC	울산광역시
통영IC	경상남도
통일로IC	경기도
퇴계원IC	경기도
판교IC	경기도
판교JC	경기도
판암IC	대전광역시
팔곡JC	경기도
팔공산IC	대구광역시
평촌IC	서울특별시
평택JC	경기도
포항IC	경상북도
풍기IC	경상북도
하남IC	경기도
하남JC	경기도
하동IC	경상남도
하산운터널남측	경기도
하산운터널북측	경기도
하조대IC	강원도
학산IC	전라남도
학의JC	경기도
학익JC	인천광역시
한남IC	서울특별시
함안IC	경상남도
함양IC	경상남도
함양JC	경상남도
함평IC	전라남도
함평JC	전라남도
해룡IC	전라남도
해미IC	충청남도
해운대IC	부산광역시
해인사IC	경상남도
향남IC	경기도
헌릉IC	서울특별시
현남IC	강원도
현풍JC	대구광역시
호법JC	경기도
홍성IC	충청남도
홍천IC	강원도
화도IC	경기도
화서IC	경상북도
화원옥포IC	대구광역시
화원옥포TG	대구광역시
황간IC	충청북도
황천IC	전라남도
회덕JC	대전광역시
회인IC	충청북도
횡계IC	강원도
횡성IC	강원도
흥덕IC	경기도
